111111111111111111111111111111
1P000000000000C0000000000000E1
101111011101110111101110111101
100000010000000000010000000001
111101011101011110101110101101
1C000000C000000000000C00000001
101110111011101110111011101101
100000000000C00000000000000001
111011101110111101110111011101
1C000000000000000000000000C001
101110101110111011101110101101
100000000C000000C0000000000001
111011101110111101110111011101
100000000000000000000000000001
111111111111111111111111111111
